SakiManager	KEYWORD1
SakiConfig	KEYWORD1
SakiConfigItem	KEYWORD1
send	KEYWORD2
reply	KEYWORD2
check	KEYWORD2
handle	KEYWORD2
set	KEYWORD2
get	KEYWORD2
registerHandler	KEYWORD2
registerDefaultHandler	KEYWORD2
clockTime	KEYWORD2
tick	KEYWORD2
setDigitalInput	KEYWORD2
setDigitalOutput	KEYWORD2
setAnalogInput	KEYWORD2
report	KEYWORD2
setAlarm	KEYWORD2
isAlarmed	KEYWORD2
clearAlarm	KEYWORD2
